LIST OF TAGS

Verb : VERB
Verbal Auxiliary : VERBaux
Past Participal : VERBppass
Present Participal : VERBppres
Substantive : SUB
Masculine Substantive : SUBm
Feminine Substantive : SUBf
Adjective : ADJ
Adverb : ADV
Negative Adverb : ADVneg
Location Adverb :  ADVplace
Temporal Adverb : ADVtemp
Quantitative Adverb : ADVquant
Indefinite Adverb : ADVindef
Interrogative Adverb : ADVinter
Preposition : PREP
"Déterminant" (qualifier) : DET
"Article Défini" : DETart
"Article Contracté" : DETprep
"Article Numéral" : DETnum
"Article Indéfini" : DETindef
"Article Interrogatif" : DETinter
"Article Démonstratif" : DETdem
"Article Possessif" : DETposs
Pronoun : PRO
Personal Pronoun : PROpers
Relative Pronoun : PROrel
Indefinite Pronoun : PROindef
Interrogative Pronoun : PROint
Demonstrative Pronoun : PROdem
Possessive Pronoun : PROposs
Conjunction : CONJ
Coordinate Conjunction : CONJcoord
Subordinate Conjunction : CONJsubord
Proper Noun : NAME
Human Proper Noun : NAMEpers
Human Male Proper Noun : NAMEpersm
Human Female Proper Noun : NAMEpersf
Place Proper Noun : NAMEplace
People Proper Noun : NAMEpeople
Event Proper Noun : NAMEevent
Author Proper Noun : NAMEauthor
Title Proper Noun : NAMEtitle
Animal Proper Noun : NAMEanimal
Half-Human Proper Noun : NAMEdemhum
God Proper Noun : NAMEgod
Number : NUM
Punctuation : PUN
Sentence Punctuation : PUNsent
Light Punctuation : PUNcl
Abbreviation : ABBR